000000000000000
000000000000000
000000000000000
000000000000000
000100000011000
000001000100000
000000010000000
000000010000000
000011001000000
000110000110000
000110000011000
000000000000000
000110000011000
000000110000000
000000000000000